   EEEEEEEEEEEEEEEEEEEEEEEEEEEEEEEEEEEEEEEEEEEEEEEEEEEEEEEEEE
   E                       E  E        E     E              E
E  EEEEEEEEEE  EEEEEEEEEEEEE  E  EEEEEEE  EEEE  EEEEEEEEEEEEE
E  E           E           E        E        E  E     E     E
E  EEEEEEE  E  E  EEEE  EEEE  EEEEEEE  E  EEEE  E  EEEEEEE  E
E  E  E     E        E  E     E  E  E  E  E                 E				VIM IN EVIL LAND
E  E  E  E  EEEEEEE  EEEEEEE  E  E  E  EEEE  E  E  EEEE  EEEE
E     E  E        E  E  E           E  E  E  E  E     E     E     			     level2
E  EEEEEEE  EEEEEEE  E  EEEEEEE  E  E  E  E  EEEE  EEEEEEEEEE
E     E     E                    E     E  E     E        E  E
E  E  E  E  EEEEEEE  E  EEEE  EEEEEEEEEE  EEEEEEE  E  EEEE  E
E  E     E  E     E  E     E  E     E     E  E     E  E  E  E
E  EEEEEEEEEEEEE  E  EEEEEEE  EEEE  EEEE  E  E  E  EEEE  E  E
E  E  E  E        E        E        E     E  E  E           E
E  E  E  EEEE  EEEEEEEEEEEEEEEE  EEEEEEE  E  EEEE  EEEE  E  E
E        E     E           E  E     E  E           E     E  E
EEEE  EEEE  EEEE  EEEEEEEEEE  EEEE  E  E  EEEEEEE  E  EEEEEEE
E                          E           E     E  E  E  E     E
E  E  E  E  EEEEEEE  E  E  E  EEEEEEE  E  E  E  E  EEEE  EEEE
E  E  E  E  E     E  E  E  E  E           E  E        E     E
EEEEEEE  EEEE  E  EEEEEEEEEE  EEEEEEEEEEEEE  E  EEEE  E  E  E
E  E     E  E  E  E                 E  E  E  E  E        E  E
E  EEEE  E  EEEE  E  E  E  EEEE  E  E  E  E  EEEE  E  E  E  E
E           E        E  E  E     E     E        E  E  E  E  E
EEEE  EEEE  E  E  EEEEEEEEEEEEE  EEEE  EEEEEEE  EEEEEEE  EEEE
E        E  E  E  E  E  E        E  E     E     E  E  E     E
E  EEEE  E  EEEE  E  E  EEEE  EEEE  EEEEEEEEEE  E  E  EEEE  E
E  E     E  E  E  E     E           E        E  E           E
E  EEEE  EEEE  EEEE  EEEE  E  E  EEEE  E  E  EEEE  EEEEEEE  E
E  E        E              E  E        E  E     E  E        
EEEEEEEEEEEEEEEEEEEEEEEEEEEEEEEEEEEEEEEEEEEEEEEEEEEEEEEEEE  

