   EEEEEEEEEEEEEEEEEEEEEEEEEEEEEEEEEEEEEEEEEEEEEEEEEEEEEEEEEE
      E        E  E           E                 E     E  E  E
E  EEEEEEE  EEEE  E  E  EEEE  E  EEEE  EEEE  EEEEEEE  E  E  E
E     E        E  E  E     E     E  E  E           E     E  E
E  E  E  EEEEEEE  EEEE  EEEE  E  E  E  E  EEEE  EEEE  EEEE  E
E  E  E     E     E  E  E  E  E  E  E  E  E     E        E  E				VIM IN EVIL LAND
EEEE  E  EEEE  E  E  E  E  E  EEEE  EEEEEEE  E  E  E  E  E  E
E  E        E  E        E  E     E     E     E     E  E  E  E				     LEVEL3 
E  EEEE  EEEEEEE  E  E  E  E  EEEEEEE  E  EEEE  EEEEEEE  E  E
E  E        E     E  E  E     E           E  E  E  E  E  E  E
E  EEEEEEE  E  E  EEEE  EEEEEEEEEEEEEEEEEEE  E  E  E  E  E  E
E     E  E  E  E  E                       E     E  E  E     E
E  EEEE  E  EEEEEEEEEE  E  E  EEEE  EEEEEEEEEEEEE  E  E  EEEE
E        E  E     E     E  E  E  E  E     E  E     E  E     E
E  EEEE  E  E  E  E  EEEEEEEEEE  E  EEEE  E  E  EEEE  E  E  E
E  E  E     E  E        E  E                       E     E  E
E  E  EEEEEEEEEE  E  EEEE  E  EEEE  EEEEEEE  EEEE  EEEEEEEEEE
E              E  E  E           E     E        E     E     E
EEEEEEE  E  EEEE  EEEEEEEEEE  E  EEEEEEE  EEEEEEEEEEEEE  EEEE
E        E  E     E  E     E  E        E  E  E              E
E  E  EEEEEEE  E  E  EEEE  EEEE  E  E  EEEE  E  EEEE  E  EEEE
E  E           E        E        E  E        E     E  E  E  E
EEEEEEE  EEEEEEEEEEEEEEEE  EEEEEEE  EEEEEEE  E  E  E  EEEE  E
E           E     E           E        E  E     E  E        E
E  EEEEEEEEEE  EEEE  E  EEEE  EEEEEEE  E  EEEE  EEEEEEEEEE  E
E  E     E     E     E  E  E  E     E  E     E        E     E
E  EEEE  EEEE  EEEEEEEEEE  E  E  EEEE  E  E  EEEE  E  E  EEEE
E           E     E        E     E  E     E     E  E  E  E  E
EEEEEEE  EEEE  E  E  EEEEEEEEEE  E  EEEE  EEEEEEEEEEEEE  E  E
E              E              E        E              E     
EEEEEEEEEEEEEEEEEEEEEEEEEEEEEEEEEEEEEEEEEEEEEEEEEEEEEEEEEE  

